Name: Simple Platforming
##########################
#                        #
#     #    #    #    #    #
#                        #
#     #    #    #    #    #
#                        #
#     #    #    #    #    #
##########################
