Name: Platforming with Spikes
##########################
#                        #
#     #    #    #    #    #
#        @               #
#     #    #    #    #    #
#        @               #
#     #    #    #    #    #
##########################
